date,description,debit,credit,balance
2024-01-01,Opening Balance,,50000.00,50000.00
2024-01-02,UPI-AMAZON PAY,,1500.00,48500.00
2024-01-03,SALARY CREDIT,,75000.00,123500.00
2024-01-05,ATM WITHDRAWAL,2000.00,,121500.00
2024-01-07,ONLINE TRANSFER TO SAVINGS,5000.00,,116500.00
2024-01-10,INTEREST CREDIT,,125.50,116625.50
2024-01-15,ELECTRICITY BILL,,3200.00,113425.50
2024-01-20,UPI-GROCERIES,,850.00,112575.50
2024-01-25,DIVIDEND CREDIT,,2500.00,115075.50
