date,description,debit,credit,balance
2024-01-01,Opening Balance,,25000.00,25000.00
2024-01-03,NEFT TRANSFER,5000.00,,20000.00
2024-01-05,INTEREST EARNED,,15.75,20015.75
2024-01-08,ATM CASH WITHDRAWAL,1000.00,,19015.75
2024-01-12,SALARY DEPOSIT,,45000.00,64015.75
2024-01-15,ONLINE PURCHASE,2500.00,,61515.75
2024-01-20,DIVIDEND RECEIVED,,1200.00,62715.75